0,0,0,0,0,0,0,0
0,0,0,0,0,0,0,0
0,0,0,0,0,0,0,0
2,2,10,5,2,0,0,0
10,2,5,7,7,2,0,0
8,7,5,8,8,7,0,0
11,7,12,11,11,7,0,0
12,7,8,12,12,6,0,0
8,6,10,8,8,6,0,0
10,6,11,10,10,2,10,0
11,6,12,11,11,5,2,0
6,5,6,12,12,5,5,0
0,0,0,0,0,0,0,0
