0,0,0,0,0,0,0,0
0,0,0,0,0,0,0,0
0,0,0,0,0,0,0,0
0,0,0,0,0,0,0,0
6,5,6,5,0,0,0,0
5,6,5,6,0,0,0,0
1,1,1,2,0,0,0,0
2,2,1,8,0,0,0,0
2,8,3,8,0,0,0,0
10,8,10,4,0,0,0,0
10,4,10,4,0,0,0,0
3,4,3,3,0,0,0,0
0,0,0,0,0,0,0,0
