0,0,0,0,0,0,0,0
0,0,0,0,0,0,0,0
0,0,0,0,0,0,0,0
12,12,12,12,0,0,0,0
9,2,6,2,0,0,0,0
9,6,7,2,0,0,0,0
9,7,6,2,0,0,0,0
7,6,5,9,0,0,0,0
3,4,4,10,0,0,0,0
4,3,10,4,0,0,0,0
5,10,3,7,0,0,0,0
10,5,5,3,0,0,0,0
0,0,0,0,0,0,0,0
