0,0,0,0,0,0,0,0
0,0,0,0,0,0,0,0
0,0,0,0,0,0,0,0
0,0,0,0,0,0,0,0
6,5,6,0,0,0,0,0
3,5,8,0,0,0,0,0
8,7,8,0,0,0,0,0
7,6,7,0,0,0,0,0
4,1,4,0,0,0,0,0
1,2,1,0,0,0,0,0
2,3,4,0,0,0,0,0
3,2,5,0,0,0,0,0
0,0,0,0,0,0,0,0
