0,0,0,0,0,0,0,0
7,0,0,0,0,0,0,0
3,12,0,0,0,0,0,0
3,7,12,0,0,0,0,0
3,10,6,12,0,0,0,0
3,7,4,10,12,0,0,0
9,6,9,9,10,0,0,0
2,9,10,7,9,0,0,0
2,6,7,6,2,0,0,0
2,4,10,4,3,0,0,0
2,5,4,12,5,0,0,0
5,6,5,5,4,0,0,0
0,0,0,0,0,0,0,0
