0,0,0,0,0,0,0,0
0,0,0,0,0,0,0,0
0,0,0,0,0,0,0,0
0,0,0,0,0,0,0,0
0,0,0,0,0,0,0,0
2,5,7,0,0,0,0,0
7,1,3,0,0,0,0,0
7,4,6,0,0,0,0,0
6,6,4,0,0,0,0,0
5,2,1,0,0,0,0,0
5,3,2,0,0,0,0,0
4,1,3,0,0,0,0,0
0,0,0,0,0,0,0,0
