0,0,0,0,0,0,0,0
0,0,0,0,0,0,0,0
10,0,0,0,0,0,0,0
12,4,9,5,0,0,0,0
12,4,12,6,0,0,0,0
9,10,9,7,0,0,0,0
4,5,10,3,0,0,0,0
7,9,12,6,0,0,0,0
4,7,5,9,0,0,0,0
5,6,5,6,3,0,0,0
10,12,3,10,6,0,0,0
3,7,3,4,7,0,0,0
0,0,0,0,0,0,0,0
