0,0,0,0,0,0,0,0
0,0,0,0,0,0,0,0
0,0,0,0,0,0,0,0
0,0,0,0,0,0,0,0
0,0,0,0,0,0,0,0
1,3,2,0,0,0,0,0
3,2,1,0,0,0,0,0
2,1,3,0,0,0,0,0
4,5,6,0,0,0,0,0
5,4,6,0,0,0,0,0
4,5,10,0,0,0,0,0
10,10,6,0,0,0,0,0
0,0,0,0,0,0,0,0
