0,0,0,0,0,0,0,0
0,0,0,0,0,0,0,0
0,0,0,0,0,0,0,0
0,0,0,0,0,0,0,0
3,9,12,3,10,0,0,0
9,6,12,7,5,0,0,0
12,7,6,5,12,0,0,0
3,6,6,5,5,0,0,0
7,4,4,10,10,0,0,0
4,5,4,10,6,0,0,0
12,10,7,9,4,0,0,0
3,9,3,7,9,0,0,0
0,0,0,0,0,0,0,0
