0,0,0,0,0,0,0,0
0,0,0,0,0,0,0,0
0,0,0,0,0,0,0,0
12,1,5,5,0,0,0,0
1,7,7,12,5,0,0,0
1,7,12,7,5,0,0,0
11,1,4,4,1,0,0,0
11,10,11,11,1,0,0,0
11,2,5,5,2,2,0,0
2,10,12,7,4,10,0,0
2,10,7,12,4,10,0,0
12,2,4,4,11,10,0,0
0,0,0,0,0,0,0,0
