0,0,0,0,0,0,0,0
0,0,0,0,0,0,0,0
0,0,0,0,0,0,0,0
0,0,0,0,0,0,0,0
12,9,12,9,0,0,0,0
5,3,5,9,0,0,0,0
4,2,4,9,0,0,0,0
2,3,5,12,0,0,0,0
4,2,4,5,0,0,0,0
10,3,1,10,0,0,0,0
10,2,1,10,0,0,0,0
1,1,3,12,0,0,0,0
0,0,0,0,0,0,0,0
