0,0,0,0,0,0,0,0
0,0,0,0,0,0,0,0
0,0,0,0,0,0,0,0
4,12,11,0,0,0,0,0
12,4,6,0,0,0,0,0
4,12,2,11,0,0,0,0
5,4,11,6,0,0,0,0
7,5,6,2,6,0,0,0
5,7,2,5,2,0,0,0
7,12,6,7,12,6,0,0
11,2,11,5,7,5,0,0
2,11,4,12,4,7,0,0
0,0,0,0,0,0,0,0
