0,0,0,0,0,0,0,0
0,0,0,0,0,0,0,0
11,8,0,0,0,0,0,0
11,12,12,6,6,0,0,0
5,5,12,6,1,0,0,0
5,7,8,8,7,7,0,0
7,7,8,6,6,7,0,0
8,11,11,4,6,12,0,0
4,4,11,4,10,12,0,0
1,4,5,5,4,10,0,0
1,10,5,8,1,10,0,0
12,1,10,1,10,11,0,0
0,0,0,0,0,0,0,0
