0,0,0,0,0,0,0,0
0,0,0,0,0,0,0,0
9,9,9,0,0,0,0,0
7,7,7,9,7,0,0,0
1,12,1,11,9,7,0,0
11,2,3,2,3,2,9,0
12,3,2,3,2,3,9,0
11,8,1,11,1,8,7,0
1,5,2,12,2,5,7,0
12,3,12,1,11,3,11,0
11,5,8,5,8,5,1,0
12,8,5,8,5,8,12,0
0,0,0,0,0,0,0,0
