0,0,0,0,0,0,0,0
0,0,0,0,0,0,0,0
0,0,0,0,0,0,0,0
0,0,0,0,0,0,0,0
7,5,0,0,0,0,0,0
4,12,4,0,0,0,0,0
12,1,2,1,12,0,0,0
1,10,4,10,1,0,0,0
2,10,4,10,2,0,0,0
12,7,10,7,12,0,0,0
5,7,4,7,5,0,0,0
2,5,1,5,2,0,0,0
0,0,0,0,0,0,0,0
